5,5,5,5,5,5,5,5,5,5,5,5,5,5,5,5,5,5,5,5,5,5,
5,0,0,0,0,0,0,0,0,0,0,0,0,0,1,0,0,0,0,0,0,5,
5,0,0,0,0,0,0,0,0,0,0,0,0,0,1,0,0,0,0,0,0,5,
5,0,0,0,0,5,0,0,0,0,0,0,0,0,1,0,0,0,0,0,0,5,
5,0,0,0,0,0,0,1,1,1,1,1,1,1,1,0,0,0,0,0,0,5,
5,0,0,5,0,0,0,0,0,0,0,0,0,0,0,0,0,0,0,0,0,5,
5,0,0,0,0,0,0,0,0,0,0,0,0,0,0,0,0,0,0,0,0,5,
5,0,0,0,0,0,0,0,0,0,0,0,0,0,0,0,0,0,0,0,0,5,
5,0,5,0,0,0,0,0,0,0,0,0,0,0,7,7,0,0,0,0,0,5,
5,0,0,0,0,0,0,4,0,0,4,0,0,0,0,0,0,0,6,6,6,5,
5,0,0,0,0,0,0,0,0,0,0,0,0,0,0,0,0,6,6,6,6,5,
5,0,0,5,5,5,0,0,0,0,0,0,0,0,0,6,6,6,6,6,6,5,
5,0,0,0,0,0,0,0,0,0,0,0,0,0,6,6,0,0,0,0,0,5,
5,0,0,0,0,0,0,0,0,0,0,2,0,0,0,0,0,0,0,0,0,5,
5,0,0,0,0,0,0,0,0,0,2,3,0,0,0,0,0,0,0,0,0,5,
5,0,0,0,0,0,0,0,0,0,0,0,0,0,0,0,0,0,0,0,0,5,
5,0,0,0,0,0,0,0,4,4,0,0,0,0,0,0,0,0,0,0,0,5,
5,0,0,0,0,0,0,0,0,0,0,0,0,0,0,0,0,0,0,0,0,5,
5,0,0,0,2,2,0,0,0,0,0,0,0,0,0,0,0,0,0,0,0,5,
5,0,0,0,0,0,0,0,0,0,0,0,0,0,0,0,0,0,0,0,0,5,
5,2,0,0,0,0,0,0,0,0,0,0,0,0,0,0,0,0,0,0,0,5,
5,3,2,0,0,0,0,0,0,0,0,0,0,0,0,0,0,0,0,0,0,5,
5,3,3,2,0,0,0,0,0,0,0,0,0,0,0,0,0,0,0,0,0,5,
5,5,5,5,5,5,5,5,5,5,5,5,5,5,5,5,5,5,5,5,5,5
